0000001000
0000001000
0010001110
0010111000
0010001000
0010001B00
0010000000
A010000000